Separator=|
Languages=ko
---
SharedResource
Search|Search|검색
Download|Download|다운로드
Browse|Browse|찾아보기
Settings|Settings|설정
AppInfo|App Info|앱 정보
---
Pages\SearchPage
Reload|Reload|다시 불러오기
ClearAll|Clear All|모두 지우기
AutoSave|Auto Save|자동 저장
Next|Next|다음
Finish|Finish|마침
Walkthrough1|1. Create and edit tag filters here.|1. 여기에서 태그 필터를 생성하고 수정하세요.
Walkthrough2|2. Select tag filters to include or exclude.|2. 포함 또는 제외할 태그 필터를 선택하세요.
Walkthrough3|3. Select a language, a type and optionally enter a title search keyword.|3. 언어, 타입을 선택하고 선택적으로 검색할 제목 키워드를 입력하세요.
Walkthrough4|4. Create search links and use them to search for galleries.|4. 검색 링크를 생성하고 갤러리를 검색하는데 사용하세요.
Include|Include|포함
Exclude|Exclude|제외
SearchLinkButtonText|Create/Copy Search Link|검색 링크를 생성/복사하기
---
Pages\SettingsPage
Automatic|Automatic|자동
GlobalSettings|Global Settings|전체 설정
---
Components\TagFilterEditor
SelectPlaceholder|Select a tag filter|태그 필터를 선택하세요
Create|Create a new tag filter|새로운 태그 필터를 생성하기
Rename|Rename|이름 바꾸기
Save|Save|저장
Delete|Delete|삭제
---
Components\LTKSearchView
Language|Language|언어
Type|Type|타입
TitleKeyword|Title Keyword|제목 키워드
All|All|전체
Doujinshi|Doujinshi|동인지
Manga|Manga|망가
ArtistCG|Artist CG|작가 CG
GameCG|Game CG|게임 CG
Imageset|Imageset|이미지 모음
Anime|Anime|애니메이션
---
Components\TagSearchPanel
Tag|Tag|태그
Artist|Artist|작가
Male|Male|남성
Female|Female|여성
Group|Group|그룹
Character|Character|캐릭터
Series|Series|시리즈